1111111111111111111
1E1000000000000C001
1110010100100000101
1010010011101010001
1P0000001C00C000001
1111111111111111111