1111111111111
1001000000001
1000110111111
1PC1E10000001
1111111111111